> Movement Keys
movementFlyingUp = E
movementFlyingDown = Q
movementFlyingForward = W
movementFlyingBack = S
movementFlyingRight = D
movementFlyingLeft = A

> Camera Keys
cameraRotateUp = UP
cameraRotateDown = DOWN
cameraRotateRight = RIGHT
cameraRotateLeft = LEFT
orthoOffset = MBMIDDLE
orthoZoomIn = MBSCROLLUP
orthoZoomOut = MBSCROLLDOWN
orthoResetOffset = NUMPADPERIOD
perspectiveToggle = NUMPAD0

> Debug Keys
debugRenderWireframe = COMMA
debugRenderEdgesNumbers = PERIOD
debugRenderDisplayAxis = SLASH

> Debug Menu Keys
toggleConsole = TILDE
toggleDebugMenu = LCTRL + TILDE
toggleDebugBar = LSHIFT + TILDE
toggleMenuBar = LALT + TILDE

> Selected Object Manipulation Modes
grabSelectedObject = G
rotateSelectedObject = R
scaleSelectedObject = S

> Undo/Redo
undo = LCTRL + Z
redo = LCTRL + Y

